111111111111
1C000CC00P11
1C0111111111
1C000CC01111
100000000111
111111100111
1CEE000C0111
111111111111
