111111111111
1CCCCCCCCP11
1CC111111111
1CCCCCCC1111
1CCCCCCCC111
1111111CC111
1CCCCCCCE111
111111111111
