1111111
1000tP1
1C0E001
1111111