111111111111
100000000P11
100111111111
100000001111
100000000111
111111100111
10E000000111
111111111111
