111111111111
1EEEEEEEEE11
1EEEEEEEE111
1EEEEEEE1111
1EEEEEEEEEE1
11EEEEEEEE11
1ECPEEEEEE11
111111111111