100000000C00001
1E0011111111001
100C000000C1101
1C0000C001111C1
111111000011111
1P1111100011111
10100010C00C111
100C10000011111
111111111111111