111111111111
100000000P11
100111111111
10000E001111
1000000C0111
111111100111
100000000111
111111111111