11111
1CPE1
11101
11111
11111
11111