111111111111
11CCCCCCCP11
1111110CC111
1CCCCCCCE111
111111111111
 11111111111