1111111111111111111111111111111111
1E0010C000000000000011111111111111
1000111000000000000011111111111111
1P00000000000000000011111111111111
1E0010C000000000000011111111111111
1E0010C000000000000011111111111111
1E0010C000000000000011111111111111
1E0010C000000000000011111111111111
1E0010C000000000000011111111111111
1E0010C000000000000011111111111111
1E0010C000000000000011111111111111
1E0010C000000000000011111111111111
1E0010C000000000000011111111111111
1E0010C000000000000011111111111111
1E0010C000000000000011111111111111
1E0010C000000000000011111111111111
1E0010C000000000000011111111111111
1E0010C000000000000011111111111111
1E0010C000000000000011111111111111
1111111111111111111111111111111111
1111111111111111111111111111111111
1111111111111111111111111111111111
1111111111111111111111111111111111
1111111111111111111111111111111111
1111111111111111111111111111111111
1111111111111111111111111111111111
1111111111111111111111111111111111
1111111111111111111111111111111111
1111111111111111111111111111111111
1111111111111111111111111111111111
1111111111111111111111111111111111
1111111111111111111111111111111111
1111111111111111111111111111111111
1111111111111111111111111111111111
1111111111111111111111111111111111