111111111111
100000000P11
1C0000000111
1C0000000111
1C0000000111
1CE000000111
111111111111
